000000000000000
000011000000000
000011111010000
000011111100000
000000001000000
000000010000000
011111010011100
011111111111110
111001111111110
110001111111110
011111111111110
011111111111100
001111111111100
000111111111000
000001111110000