000111000000001
001111100111111
001100011110001
011010111001011
010101110110011
010101101010110
010011001110110
011011011001111
101010100011110
010110001111000
001111110010000
000111001011000
000011100001000
000011011001100
000001101110000