001110110000000
011111111000000
111111111100000
111100001100000
011011110000000
000111101100000
011110110110000
111111110111000
000111100111000
001111001111100
000011011111100
000011011111110
000000111111110
000001111111110
000011111111111