000000010000000
000000010000000
000100111001000
100110111011001
110111111111011
111111101111111
110111101111011
110011000110011
111001000100111
011000000000110
011000000000110
011101010101110
001100000001100
001111111111100
001111111111100