110110000001101
110110100101101
011110100101101
001111100011111
000011011111000
000000111111100
000001010111110
000011111111111
000111111111111
001111111111111
011111111011111
010111000011111
011111000011111
001110000111111
000000000111111