000000010000000
000000100000000
000001111000000
010001111000000
001011100001000
001100111001000
001100111101110
011110111101110
011110111101110
110001111101010
111110010011100
001111111111000
001111111111000
000111111110000
111111111111111