00000000
00101000
01111100
01111100
00111000
00010000
00000000
00000000