00000000
01111000
01100110
01100110
01111110
01111000
01100000
01100000