00000000
00111100
01111110
01111110
00100100
00010000
00001000
00011000