0000001011
0000000011
0000000100
0000000001
0000011000
1100111100
1101111110
0111111110
0000100100
0001101100