0001100000
1100111000
0100011000
0011111110
0011111011
0111111111
0110111110
1100011000
0000110000