0001111100
0011111010
0011111010
0011111110
0001111100
0000111000
0000010000
0000111000
0000111000
0000000000