0000111111
0001010101
0011010110
0101011010
0101011110
0101100010
0111111110
0010000100
0101111000
1100000000