1111000001
1111100011
0111111111
0011111111
0011111111
0010111101
0111111111
0111110111
0111100011
0111111111