0000111000
0001111000
0011101000
0111011100
1110001100
1111100110
0111100110
0000111110
0000000111
0000000011