0011111100
0110000110
0110000110
0000000110
0000001110
0000111100
0000110000
0000000000
0000110000
0000110000