00011100000000011100
00100111000000111010
00111011111111110110
00111011000000110110
00111110000000011110
00011100000000001100
00001000000000000100
00010000000000000010
00110000000000000010
00110000100000100010
01110001110001110010
10100001010001010001
10100001110001110001
00100001100000110001
10110000000000000011
01011000001110000110
10001100001110001110
01000110000100011110
10010011000000111100
11101000111111111100